6 6 4
0 4 0 2 0 3
3 4 1 4 1 2
3 3 2 2 0 0
2 2 1 4 0 1
2 3 1 3 3 0
2 1 1 3 2 1
