5 6 3
3 0 2 0 1
2 0 1 0 2
2 0 2 0 2
1 0 1 0 3
2 0 3 0 2
2 3 1 3 2
