5 6 4
3 4 4 1 1
2 2 2 0 4
0 4 2 2 2
1 1 3 3 1
1 4 0 1 4
4 0 3 2 0
