5 6 3
0 4 0 2 3
3 4 1 4 4
3 3 2 2 1
2 2 1 4 1
2 3 1 3 3
2 1 1 3 3
