5 6 1
4 3 1 2 4
1 1 4 2 3
3 0 1 1 2
2 1 1 0 0
0 2 0 4 2
2 0 1 3 0
