5 6 1
1 2 2 2 1
2 4 3 4 2
2 2 2 2 2
2 2 2 2 2
1 2 2 2 1
1 2 1 2 1
